111111111111111111111111111
1E0000000000000000000000001
100001010010000010100100101
101C01001010101000100100111
1P0000000000000000000000001
111111111111111111111111111